**************************
*   *                    *
* S *  *  *************  *
*     *    ************  *
*    *                   *
************** ***********
*                        *
** ***********************
*      *              G  *
*  *      *********** *  *
*    *        ******* *  *
*       *                *
**************************