$field = [
			['+','+','+','+','+','+','+','+','+','G'],
			['+','+','+','+','+','+','+','+','#','+'],
			['+','+','+','+','+','+','+','#','+','+'],
			['+','+','+','+','+','+','+','+','#','#'],
			['+','+','+','+','+','+','+','+','+','+'],
			['+','+','+','#','#','#','#','#','+','+'],
			['+','+','+','+','+','+','+','+','+','+'],
			['+','+','+','+','+','+','+','+','#','+'],
			['+','+','+','+','+','+','+','+','+','+'],
			['+','+','+','+','+','+','+','+','+','+'],
			['+','+','+','+','+','+','#','+','+','+'],
			['+','+','+','+','+','#','+','#','+','+'],
			['+','+','+','+','#','+','+','+','+','+'],
			['+','+','+','+','+','+','+','+','+','+'],
			['+','+','+','+','+','+','+','+','+','+'],
			['+','#','+','#','#','+','+','+','+','+'],
			['#','+','#','+','+','+','+','+','+','+'],
			['+','+','+','#','+','+','+','#','+','+'],
			['+','#','+','+','+','#','+','#','+','#'],
			['S','#','+','+','+','+','+','+','+','+']
		]


